ItemName	Type
Item_LingStone	原料
Item_LingCrystal	原料
Item_BrownRock	原料
Item_GrayRock	原料
Item_Marble	原料
Item_Jade	原料
Item_JadeEssence	原料
Item_StoneEssence	原料
Item_SkyStone	原料
Item_IronRock	原料
Item_CopperRock	原料
Item_SilverRock	原料
Item_DarksteelRock	原料
Item_Wood	原料
Item_HardWood	原料
Item_ParasolWood	原料
Item_LingWood	原料
Item_SilverGrit	原料
Item_CopperGrit	原料
Item_Cinnabar	原料
Item_LingMuXueJie	原料
Item_EarthEssence_1	原料
Item_EarthEssence1_1	原料
Item_Ginkgo	原料
Item_SnakeGallbladder	原料
Item_BearGallbladder	原料
Item_Healroot	原料
Item_Grass	原料
Item_Cotton	原料
Item_Shit	原料
Item_DragonShit	原料
Item_IronBlock	材料
Item_CopperBlock	材料
Item_SilverBlock	材料
Item_CopperBlock1	材料
Item_SilverBlock1	材料
Item_DarksteelBlock	材料
Item_StarEssenceBlock	材料
Item_BrownRockBlock	材料
Item_GrayRockBlock	材料
Item_MarbleBlock	材料
Item_JadeBlock	材料
Item_SkyStoneBlock	材料
Item_LingStoneBlock	材料
Item_LingCrystalBlock	材料
Item_RoughWoodBlock	材料
Item_HardWoodBlock	材料
Item_ParasolWoodBlock	材料
Item_LingWoodBlock	材料
Item_SpellPaper	材料
Item_SpellPaperLv2	材料
Item_SpellPaperLv3	材料
Item_CottonCloth	材料
Item_DeepBlueCloth	材料
Item_PurpleCloth	材料
Item_YellowCloth	材料
Item_BlueCloth	材料
Item_RedCloth	材料
Item_WhiteCloth	材料
Item_BlackCloth	材料
Item_WoodLeftover	材料
Item_HardWoodLeftover	材料
Item_ParasolWoodLeftover	材料
Item_LingWoodLeftover	材料
Item_BrownRockLeftover	材料
Item_GrayRockLeftover	材料
Item_MarbleLeftover	材料
Item_JadeLeftover	材料
Item_SkyStoneLeftover	材料
Item_LingStoneLeftover	材料
Item_LingCrystalLeftover	材料
Item_IronRockLeftover	材料
Item_CopperRockLeftover	材料
Item_SilverRockLeftover	材料
Item_DarksteelRockLeftover	材料
Item_StarEssenceLeftover	材料
Item_SoulCrystalYou	魂珀
Item_SoulCrystalNing	魂珀
Item_SoulCrystalLing	魂珀
Item_SoulCrystalYuanLing	魂珀
Item_Yao_CatSoul	魂珀
Item_Yao_RabbitLuck	妖兽掉落
Item_Yao_WolfAtk	妖兽掉落
Item_Yao_SnakeHanLin	妖兽掉落
Item_Yao_BearPiMao	妖兽掉落
Item_Yao_TurtleKe	妖兽掉落
Item_Yao_TigerZhui	妖兽掉落
Item_Yao_CattleJiao	妖兽掉落
Item_Yao_ChickenGuan	妖兽掉落
Item_BoarLeather	毛皮
Item_RabbitLeather	毛皮
Item_BearLeather	毛皮
Item_WolfLeather	毛皮
Item_CattleLeather	毛皮
Item_TigerLeather	毛皮
Item_FeiLeather	毛皮
Item_LuShuLeather	毛皮
Item_YaoLeather	毛皮
Item_YaoLeather1	毛皮
Item_HorribleMeal	药食
Item_HomeFood	药食
Item_DeliciousFood	药食
Item_DelicacyFood	药食
Item_GuanyinMud	药食
Item_Water	药食
Item_DirtyWater	药食
Item_Hemostatics	药食
Item_SmallCycle	药食
Item_Plaster	药食
Item_StoneEssenceDrug	药食
Item_Anodyne	药食
Item_Laxative	药食
Item_Fruit	药食
Item_LingWater	药食
Item_ZaoHuaYuLu	药食
Item_Cake	药食
Item_Jerky	药食
Item_PreservedFruit	药食
Item_Yao_BoarMeat	药食
Item_Flour	药食
Item_Pear	药食
Item_Wheat	药食
Item_Mushroom	药食
Item_Lotusroot	药食
Item_BoarMeat	药食
Item_FrogMeat	药食
Item_TurtleMeat	药食
Item_BearMeat	药食
Item_Beef	药食
Item_RabbitMeat	药食
Item_ChickenMeat	药食
Item_WolfMeat	药食
Item_FishMeat	药食
Item_SnakeMeat	药食
Item_ChickenEgg	药食
Item_SnakeEgg	药食
Item_CatMeat	药食
Item_TigerMeat	药食
Item_TurtleEgg	药食
Item_RedGinseng	灵药
Item_PurpleGanodermaLucidum	灵药
Item_Ginseng	灵药
Item_GanodermaLucidum	灵药
Item_Mint	灵药
Item_MagicHerb	灵药
Item_shuxingdanj	仙丹
Item_shuxingdanm	仙丹
Item_shuxingdans	仙丹
Item_shuxingdanh	仙丹
Item_shuxingdant	仙丹
Item_shuxingdanw	仙丹
Item_yunlingdan1	仙丹
Item_yunlingdan2	仙丹
Item_yunlingdan3	仙丹
Item_yunlingdan4	仙丹
Item_daohangdan	仙丹
Item_tianqiandan	仙丹
Item_tianqiandan1	仙丹
Item_Dan_ExtremeLofty	仙丹
Item_Dan_HundredRefine	仙丹
Item_Dan_IncreaseLife1	仙丹
Item_Dan_IncreaseLife2	仙丹
Item_Dan_IncreaseLife3	仙丹
Item_Dan_IncreaseLife4	仙丹
Item_Dan_IncreaseLife5	仙丹
Item_Dan_IncreaseNeckCountdown1	仙丹
Item_Dan_IncreaseNeckCountdown2	仙丹
Item_Dan_SwordBall	仙丹
Item_Dan_Ling3	仙丹
Item_Dan_FiveBaseFromLife	仙丹
Item_Dan_TreeEXP	仙丹
Item_Dan_ReBorn	仙丹
Item_Dan_ReBorn_4	仙丹
Item_Dan_FenShen1	仙丹
Item_Dan_FenShen2	仙丹
Item_Dan_FenShen3	仙丹
Item_Dan_LongDan1	仙丹
Item_Dan_FengDan1	仙丹
Item_Dan_ZhuLongDan1	仙丹
Item_BasePracticeDrug	灵丹
Item_Dan_Ling	灵丹
Item_Dan_Ling2	灵丹
Item_Dan_PracticeRate	灵丹
Item_Dan_PracticeSpeed	灵丹
Item_Dan_CalmDown	灵丹
Item_Dan_Defense	灵丹
Item_Dan_FiveBase1	灵丹
Item_Dan_FiveBase2	灵丹
Item_Dan_FiveBase3	灵丹
Item_Dan_FiveBase4	灵丹
Item_Dan_FiveBase5	灵丹
Item_Dan_Soul1	灵丹
Item_Dan_Soul2	灵丹
Item_Dan_Soul3	灵丹
Item_Dan_Soul4	灵丹
Item_Dan_LunHui1	灵丹
Item_Dan_LingYuanZhong	灵丹
Item_Dan_TiShen	灵丹
Item_QiZhi	灵丹
Item_Fall_LingZhi	灵丹
Item_Winter_LingZhi	灵丹
Item_Spring_LingZhi	灵丹
Item_Summer_LingZhi	灵丹
Item_Earth_LingZhi	灵丹
Item_Dan_JingYuan	丹药
Item_Dan_JingYuan2	丹药
Item_Dan_JingYuan3	丹药
Item_Dan_Happiness	丹药
Item_Dan_NoHunger	丹药
Item_Dan_NoHunger2	丹药
Item_Dan_NoHunger1	丹药
Item_Dan_LostSoul	丹药
Item_Dan_DredgeQi1	丹药
Item_Dan_DredgeQi	丹药
Item_Dan_WuLingSan	丹药
Item_Dan_CureJinDamage	丹药
Item_Dan_CureMuDamage	丹药
Item_Dan_CureShuiDamage	丹药
Item_Dan_CureHuoDamage	丹药
Item_Dan_CureTuDamage	丹药
Item_Dan_CureFiveElementDamage	丹药
Item_Dan_Restore	丹药
Item_Dan_Thin	丹药
Item_Dan_Fat	丹药
Item_Dan_FaceLock	丹药
Item_Dan_FaceUnLock	丹药
Item_Dan_FaceLock1	丹药
Item_Dan_FaceLock2	丹药
Item_Dan_FaceLock3	丹药
Item_LifeStream	天材地宝
Item_MonsterBlood	天材地宝
Item_EarthEssence	天材地宝
Item_EarthEssence1	天材地宝
Item_StarEssence	天材地宝
Item_ExtremeJade	天材地宝
Item_Dan_LingYuanSha	天材地宝
Item_SoulPearl	天材地宝
Item_ThunderAir	天材地宝
Item_XianBone	天材地宝
Item_XianBoneBall	天材地宝
Item_ZaoHuaYuZi	天材地宝
Item_YuanHunLu	天材地宝
Item_XieHunLu	天材地宝
Item_YanDaoGuo	天材地宝
Item_QieDaoGuo	天材地宝
Item_XianDaoShenNian	天材地宝
Item_XianDaoXieNian	天材地宝
Item_WinterWarm	天材地宝
Item_SummerHerb	天材地宝
Item_God_ZhiNianJieJing	天材地宝
Item_God_JieHui	天材地宝
Item_JinEssence	天材地宝
Item_MuEssence	天材地宝
Item_ShuiEssence	天材地宝
Item_HuoEssence	天材地宝
Item_TuEssence	天材地宝
Item_BenYuan_None	本源
Item_BenYuan_Jin	本源
Item_BenYuan_Mu	本源
Item_BenYuan_Shui	本源
Item_BenYuan_Huo	本源
Item_BenYuan_Tu	本源
Item_BossFeng_HuoYu	神兽材料
Item_BossFeng_GangYu	神兽材料
Item_BossFeng_TouYu	神兽材料
Item_BossFeng_WeiYu	神兽材料
Item_BossFeng_Gu	神兽材料
Item_BossFeng_HongYu	神兽材料
Item_BossFeng_Meat	神兽材料
Item_DragonScale	神兽材料
Item_BossLong_Jiao	神兽材料
Item_BossLong_Zhua	神兽材料
Item_BossLong_Lin	神兽材料
Item_BossLong_NiLin	神兽材料
Item_BossLong_Jing	神兽材料
Item_BossLong_Meat	神兽材料
Item_BossZhuLong_BaiLin	神兽材料
Item_BossZhuLong_HeiLin	神兽材料
Item_BossZhuLong_Eye	神兽材料
Item_BossZhuLong_TianLin	神兽材料
Item_BossZhuLong_LongYu	神兽材料
Item_BossZhuLong_Meat	神兽材料
Item_BossFeng_FengYin	神兽材料
Item_BossZhuLong_FengYin	神兽材料
Item_Stonebook	盲盒
Item_shenfu	盲盒
Item_GodPractice_MiJuan	盲盒
Item_LunHui_Box2	盲盒
Item_ZuShiZhiCi	盲盒
Item_LunHui_Box1	盲盒
Item_E_FaBaoBox	盲盒
Item_E_DanBox	盲盒
Item_E_MiJiBox	盲盒
Item_E_FuBox	盲盒
Item_StoneBox	盲盒
Item_StoneBox1	盲盒
Item_StoneBox2	盲盒
Item_Firecracker	年货
Item_FirecrackerShit	年货
Item_Jiaozi	年货
Item_Yingbi1	年货
Item_Yingbi2	年货
Item_Yingbi3	年货
Item_SpringBox	年货
Item_StoneCutter	工具
Item_SewingDefender	工具
Item_MillVell	工具
Item_AuctionPaper	邀请函
